terra = Aspect("terra")
aqua = Aspect("aqua")
ignis = Aspect("ignis")
aer = Aspect("aer")
ordo = Aspect("ordo")
perditio = Aspect("perditio")
victus = Aspect("victus", terra, aqua)
potentia = Aspect("potentia", ignis, ordo)
vacuos = Aspect("vacuos", aer, perditio)
motus = Aspect("motus", aer, ordo)
lux = Aspect("lux", ignis, aer)
gelum = Aspect("gelum", ignis, perditio)
vitreus = Aspect("vitreus", terra, ordo)
permutatio = Aspect("permutatio", ordo, perditio)
tempestus = Aspect("tempestus", aer, aqua)
venenum = Aspect("venenum", aqua, perditio)
volatus = Aspect("volatus", motus, aer)
sano = Aspect("sano", victus, ordo)
mortuus = Aspect("motuus", victus, perditio)
herba = Aspect("herba", victus, terra)
praecantatio = Aspect("praecantatio", potentia, vacuos)
tenebrae = Aspect("tenebrae", vacuos, lux)
bestia = Aspect("bestia", motus, victus)
vinculum = Aspect("vinculum", motus, perditio)
fames = Aspect("fames", victus, vacuos)
iterAspect = Aspect("iter", motus, terra)
limus = Aspect("limus", victus, aqua)
metallum = Aspect("metallum", vitreus, terra)
vitium = Aspect("vitium", praecantatio, perditio)
superbia = Aspect("superbia", volatus, vacuos)
spiritus = Aspect("spiritus", victus, mortuus)
alienis = Aspect("alienis", vacuos, tenebrae)
arbor = Aspect("arbor", herba, aer)
auram = Aspect("auram", praecantatio, aer)
corpus = Aspect("corpus", bestia, mortuus)
exanimis = Aspect("exanimis", motus, mortuus)
gula = Aspect("gula", fames, vacuos)
infernus = Aspect("infernus", praecantatio, ignis)
cognitio = Aspect("cognitio", spiritus, ignis)
desidia = Aspect("desidia", spiritus, vinculum)
exubitor = Aspect("exubitor", alienis, mortuus)
sensus = Aspect("sensus", spiritus, aer)
luxuria = Aspect("luxuria", corpus, fames)
invidia = Aspect("invidia", fames, sensus)
humanus = Aspect("humanus", bestia, cognitio)
perfodio = Aspect("perfodio", humanus, terra)
messis = Aspect("messis", herba, humanus)
instrumentum = Aspect("instrumentum", humanus, ordo)
lucrum = Aspect("lucrum", humanus, fames)
tutamen = Aspect("tutamen", instrumentum, terra)
pannus = Aspect("pannus", instrumentum, bestia)
meto = Aspect("meto", messis, instrumentum)
machina = Aspect("machina", instrumentum, motus)
telum = Aspect("telum", instrumentum, ignis)
fabrico = Aspect("fabrico", humanus, instrumentum)
ira = Aspect("ira", telum, ignis)